NO asset/texture/NO.png
EA asset/texture/EA.png
WE asset/texture/WE.png
SO asset/texture/SO.png


F 135,235,164
C 136,205,235


1111111111  11111111
10000000N000000001
100010001100000001
100000000001000001
100001000000000001
100000011111100001
100000000000000001
111111111001111111
        1001      
        1001      
        1001      
        1001      
        1001      
        1001      
        1001      
        1001
        1001
        1001
        1001
        1001
        1001
        1001
        1001
        1001
        1001
        1001
        1001
        1001
        1001
        1001
        1001
        1001
        1001
        1001
        1001
        1001
        1001
        1001
        1001
        1001
        1001
        1001
        1001
        1001
        1001
        1001
        1001
        1001
        1001
        1001
        1001
        1001
        1001
        1001
        1001
        1001
        1001
        1001
        1001
        1001
        1001
        1001
        1111
