NO asset/texture/NO.png
EA asset/texture/EA.png
WE asset/texture/WE.png
SO asset/texture/SO.png

C 135,206,235
F 169,69,19

1111111111111111111111111
1000000000001000000111111
1000000000000000000111101
1000000000001000000111001
1000000000000000000111101
1111100000000000000000001
1000000000001000000111111
1000000000000000000111101
1000000000000000000111111
100000000000000 000011111
1111100000000000000000001
100000000000N000000000011
1000000000000000000111111
1000000000000000000111111
1000000000000000000111111
1000000000000000000111101
1111100000000000000000001
1000000000010000000110001
1000000000000000000110001
1000000000000000000110001
1000000000000000000110001
1111111111111111111111111
