NO assets/texture/context_01.png
EA assets/texture/plaster_brick_pattern.png
WE assets/texture/brick_wall_09.png
SO assets/texture/clay.png
C 245,222,179
F 135,206,235
1111111111111111111111111
1000000000000000100000001

100000000000N000100000011
1000000000000000000000001
1111111111111111111111111
