NO asset/texture/download.png
EA asset/texture/N.png
WE asset/texture/E.png
SO asset/texture/images.png
C 245,222,179
F 135,206,235
1111111111111111111111111
1000000000001000000111111
1000000000000000000111101
1000000000001000000111111
1000000000000000000111101
1111100000000000000000001
1000000000001000000111111
1000000000000000000111101
1000000000000000000111111
1000000000000000000111101
1111100000000000000000001
100000000000N000000000011
1000000000000000000111111
1000000000000000000111101
1000000000000000000111111
1000000000000000000111101
1111100000000000000000001
1000000000010000000110001
1000000000000000000110001
1000000000000000000110001
1000000000000000000110001
1111111111111111111111111
