NO asset/texture/imN.png
SO asset/texture/imS.png
WE asset/texture/imO.png
EA asset/texture/imE.png
F 0,255,127
C 173,216,230


11111111111111111111111111
10000000001100000000000011
10110000011100000000000011
10010000000000001000000011
11111111101100001110000111
10000000001100000111011111
11110111111101011100000011
11110111100001101110101001
11110111100001101110101001
11110111100001101110101001
1111011110N001101110101001
11110111100001101110101001
11110111100001101110101001
11110111100001101110101001
11110111100001101110101001
11000001110101011111010011
11111111111111111111111111
