NO asset/texture/brick_wall_09.png
SO asset/texture/clay.png
WE asset/texture/context_01.png
EA asset/texture/plaster_brick_pattern.png
C 0,0,33
F 60,179,110
11111111111111111111111111
100000000011000S0000000011
10110000011100000000000011
10010000000000001000000011
11111111101100001110000111
10000000001100000111011111
11110111111101011100000011
11110111100001101110101001
11110111100001101110101001
11110111100001101110101001
11110111100001101110101001
11110111100001101110101001
11110111100001101110101001
11110111100001101110101001
11110111100001101110101001
11000001110101011111010011
11111111111111111111111111
