WE assets/texture/afghangrandcanyon.png

SO assets/texture/baburgardenmosqe.png

NO assets/texture/carulcuboi.png
EA assets/texture/coloanainfinitului.png



F 245,222,179
C 135,206,235

1111111111111111111111111
1000000000000000100000001
100000000000N000100000001
1000000000000000000000001
1111111111111111111111111
