WE textures/bricks/brick_orange.pngg
SO textures/bricks/brick_red.png    
NO textures/bricks/brick_purple.png
EA textures/bricks/brick_green.png
F 220,100,0
C 225,30,0
11111111111111111111111111111
10000000001100000000000000001
1011000001110000000W000000001
10010000000000000000000000001
11111111101100000111000000001
10000000001100000111011111111
11110111111111011100000010001
11110111111111011101010010001
11000000110101011100000010001
10000000000000001100000010001
10000000000000001101010010001
11000001110101011111011110N01
11110111011101010101111010001
11111111111111111111111111111