WE assets/texture/afghangrandcanyon.png
SO assets/texture/baburgardenmosqe.png
NO assets/texture/carulcuboi.png
EA assets/texture/coloanainfinitului.png

F 245,222,179
C 135,206,235

1111111111111111111111111
1000000000110000000N00001
1011000001110000000000001
1001000000000000000011111
111111111011000001110000111111111
100000000011000001110111111111111
11110111111111011100000010001
11110111111111011101010010001
11000000110101011100000010001
10000000000000001100000010001
10000000000000001101010010001
11000001110101011111011110N0111
11110111111101011101111010001
11111111111111111111111111111

